11111111111111111111
1.................O1
1..................1
1..................1
1..................1
1..................1
1..................1
1P.................1
11111111111111111111
